7 12

XXXXXXXXXXXX
XK.........X
X.C...C..F.X
XXX........X
X....F..C..X
X..C....F..X
XXXXXXXXXXXX


