12 30

XXXXXXXXXXXXXXXXXXXXXXXXXXXXXX
XK...........................X
X..C....F....................X
X..C....F....................X
X.C...C..F...................X
XXX.....................F....X
X....F..C....................X
X......F.....................X
X..C....F....................X
X.......F...............C....X
X..C....F....................X
XXXXXXXXXXXXXXXXXXXXXXXXXXXXXX
